 1  2  2  2  2  2  2  2  2  2  2  2  2  2  2  2  2  2  2  2  2  2  2  2  2  2  2  2  2  2  2  2  2  2  2  2  2  2  2  2  2  2  2  2  2  2  2  2  2  2  2  2  2  2  2  2  2  2  2  1  0
 1  2  2  2  2  2  2  2  2  2  2  2  2  2  2  2  2  2  2  2  2  2  2  2  2  2  2  2  2  2  2  2  2  2  2  2  2  2  2  2  2  2  2  2  2  2  2  2  2  2  2  2  2  2  2  2  2  2  2  1  0 
 1  1  1  1  1  1  1  1  1  1  1  1  1  1  1  1  1  1  1  1  1  1  1  1  1  1  1  1  1  1  1  1  1  1  1  1  1  1  1  1  1  1  1  1  1  1  1  1  1  1  1  1  1  1  1  1  1  1  1  1  0 
 1  0  0  0  0  0  0  0  0  0  0  0  1  0  0  0  0  0  0  0  0  0  0  0  0  0  0  0  0  0  0  0  0  0  0  0  0  0  0  0  0  0  0  0  0  0  0  0  0  0  0  0  0  0  0  0  0  0  0  1  0 
 1  0  0  0  0  0  0  0  0  0  0  0  1  0  0  0  0  0  0  0  0  0  0  0  0  0  0  0  0  0  0  0  0  0  0  0  0  0  0  0  0  0  0  0  0  0  0  0  0  0  0  0  0  0  0  0  0  0  0  1  0
 1  0  0  0  0  0  0  0  0  0  0  0  1  0  0  0  0  0  0  0  0  0  0  0  0  0  0  0  0  0  0  0  0  0  0  0  0  0  0  0  0  0  0  0  0  0  0  0  0  0  0  0  0  0  0  0  0  0  0  1  0
 1  4 20  6 20 20  0  0  0  0  0  0  1  0  0  0  0  0  0  0  0  0  0  0  0  0  0  0  0  0  0  0  0  0  0  0  0  0  0  0  0  0  0  0  0  0  0  0  0  0  0  0  0  0  0  0  0  0  0  1  0
 1  1  1  1  1  1  1  1  0  0  0  0  1  0  0  0  0  0  0  0  0  0  0  0  0  0  0  0  0  0  0  0  0  0  0  0  0  0  0  0  0  0  0  0  0  0  0  0  0  0  6  6  6  6  0  0  0 20 20  1  0
 1  0  0  0  0  0  0  0  0  0  0  0  1  0  0  0  0  0  0  0  1  0  0  0  0  0  0  0  0  0  0  0  0  0  0  0  1  1  1  1  1  1  1  0  0  1  1  1  1  1  1  1  1  1  1  5  5  1  1  1  0
 1  0  0  0  0  0  0  0  0 20 20 20  1  0  0  0  0  0  0  0  1  0  0  0  0  0  0  0  0  0  0  0  0  0  0  0  0  0  0  0  0  0  1  0  0  1  0  0  0  0  0  0  0  1  1  5  5  1  1  1  0
 1  0  0  0  0  0  0  0  0  1  1  1  1  0  0  0  0  0  0  0  1  0  0  0  0  0  0  0  1  1  0  0  0  0  0  0  0  0  0  0  0  0  1 10 10  1  0  0  0  0  0  0  0  0  0  5  5  0  0  1  0
 1  0  0  0  0  0  0  0  0  0  0  0  0  0  0  0  0  0  0  0  1  0  0  0  0  0  0  0  0  0  0  0  1  1  1  0  0  0  0  0  0  0  1  1  1  1  0  0  0  0  0  0  0  0  0  5  5  0  0  1  0
 1 20 20  0  0 20 20  0  0  0  0  0  0  0  0  0  0  0  0  0  1 11  0  0  0  0  0  0  0  0  0  0  0  0  0  0  0  0  0  0  0  0  0  0  0  0  0  0  0  0  0  0  0  0  0  5  5  0  0  1  0
 1  1  1  5  5  1  1  1  1  1  1  1  1  1  1  1  1  1  1  1  1  5  5  1  1  1  5  5  0  0  0  0  0  0  0  0  0  0  0  0  0  0  0  0  0  0  0  0  0  1  1  1  1  1  1  1  1  1  1  1  0
 1  0  0  5  5  0  0  0  1  0  0  0  0  0  0  0  0  0  0  0  0  5  5  0  0  1  5  5  0  0  0  0  0  0  0  0  0  0  0  0  0  0  0  0  0  0  0  0  0  0  0  0  0  0  0  0  0  0  0  1  0
 1  0  0  5  5  0  0  0  1  0  0  0  0  0  0  0  0  0  0  0  0  5  5  0  0  1  5  5  0  0  0  0  0  0  0  0  0  0  0  0  0  0  0  0  0  0  0  0  0  0  0  0  0  0  0  0  0  0  0  1  0
 1  0  0  5  5  0  0  0  1  0  0  0  0  0  0  0  0  0  0  0  0  5  5  0  0  1  5  5  0  0  0  0  0  0  0  0  0  0  0  0  0  0  0  0  0  0  0  0  0  0  0  0  0  0  0  0  0  0  0  1  0
 1  0  0  5  5  0  0  0  1  0  0  0  0  0  0  0  0  0  0  0  0  5  5  0  0  1  5  5  0  0  0  0  0  0  0  0  0  0  0  1  0  0  0  0  0  0  0  0  0  0  0  0  0  0  0  0  0  6  6  1  0
 1  0  0  5  5  0  0  0  1  0  0  0  0  0  0  0  0  0  0  0  0  5  5  0  0  1  5  5  0  0  0  0  0  0  0  0  0  0  0  1  0  0  0  5  5  1  1  1  0  0  0 20 20 20 20  6  6  1  1  1  0
 1  1  1  5  5  1  1  1  1  0  0  0  0  0  0  0  0  0  0  0  0  5  5  0  0  1  5  5  0  0  0  0  0  0  0  0  6 20  6  1  0  0  0  5  5  0  0  0  0  0  0  1  1  1  1  1  1  1  1  1  0
 1  0  0  5  5  0  0  0  0  0  0  0  0  0  0  0  0  0  0  0  0  5  5  0  0  1  1  1  1  1  1  1  1  1  1  1  1  1  1  1  0  0  0  5  5  0  0  0  0  0  0  0  0  0  0  0  0  0  0  1  0
 1  0  0  5  5  0  0  0  0  0  0  0  0  0  0  0  0  0  0  0  0  5  5  0  0  1  0  0  0  0  0  0  0  0  0  0  0  0  0  0  0  0  0  5  5  0 10 10 10 10 10 10 10 10 10 10 10 10 10  1  0
 1  0  0  5  5  0  0  0  0  0  0  0  0  0  0  0  0  0  0  0  0  5  5  0  0  1  0  0  0  0  0  0  0  0  0  0  0  0  0  0  0  0  0  5  5  1  1  1  1  1  1  1  1  1  1  1  1  1  1  1  0
 1  0  0  5  5  0  0  0  0  0  1  1  1  0  0  0  0  0  0  0  0  5  5  0  0  1  0  0  0  0  0  0  0  0  0  0  0  0  0  0  0  0  0  5  5  0  0  0  0  0  0  0  0  0  0  0  0  0  0  1  0
 1  0  0  5  5  0  0  0  0  0  0  0  0  0  0  0  0  0  0  0  0  5  5  0  0  1  0  0  0  0  0  0  0  0  0  0  0  0  0  0  0 20 20  5  5  0  0  0  0  0  0  0  0  0  0  0  0  0  0  1  0
 1 20 20  5  5 20 20  0  0  0  0  0  0  0  0  0  0  0  0 20 20  5  5  0  0  1  0  0  0  0  0  0  0  0  0  0  0  0  0  0  0  1  1  1  1  0  0  0  0  0  0  0  0  0  0  0  0  0  0  1  0
 1  1  1  1  1  1  1  1  1  0  0  0  0  0  0  1  1  1  1  1  1  1  1  1  1  1  0  0  0  0  0  0  0  0  0  0  0  0  0  0  0  0  0  0  0  0  0  0  0  0  0  0  0  0  0  0  0  0  0  1  0
 1  0  0  0  0  0  0  0  0  0  0  0  0  0  1  1  1  1 20 20 20 20 20 20 20  1  0  0  0  0  0  0  0  0  0  0  0 20 20 20  0  0  0  0  0  0  0  0  0  0  0  0  0  0  0  0  0  0  0  1  0
 1  0  0  0  0  0  0  0  0  0  0  0  0  1  1  1  1  1  0  0  0  0  0  0  0  1  0  0  0  0  0  0  0  0  0  0  0  1  1  1  0  0  0  0  0  0  0  0  0  0  0  0  0  0  0  0  0  0  0  1  0
 1  0  0  0  0  0  0  0  0  0  0  0  1  1  1  1  1  1  0  0  0  7  0  0  0  3  0  0  0  0  0  0  0  0  0  0  0  0  0  0  0  0  0  0  0  0  0  0  0  0  0  0  0  0  0  0  0  0  0  1  0
 1  0  0  0  0  0  0  0  0  0  0  1  1  1  1  1  1  1  6 20  6  0  6 20  6  1  0  0  0  0  0  0  0  0  0  0  0  0  0  0  0  0  0  0  0  0  0  0  0  0  0  0  0  0  0  0  0  0  0  1  0
 1  1  1  1  1  1  1  1  1  1  1  1  1  1  1  1  1  1  1  1  1  1  1  1  1  1  1  1  1  1  1  1  1  1  1  1  1  1  1  1  1  1  1  1  1  1  1  1  1  1  1  1  1  1  1  1  1  1  1  1  0
 1  2  2  2  2  2  2  2  2  2  2  2  2  2  2  2  2  2  2  2  2  2  2  2  2  2  2  2  2  2  2  2  2  2  2  2  2  2  2  2  2  2  2  2  2  2  2  2  2  2  2  2  2  2  2  2  2  2  2  1  0
 1  2  2  2  2  2  2  2  2  2  2  2  2  2  2  2  2  2  2  2  2  2  2  2  2  2  2  2  2  2  2  2  2  2  2  2  2  2  2  2  2  2  2  2  2  2  2  2  2  2  2  2  2  2  2  2  2  2  2  1  0
