1  2  2  2  2  2  2  2  2  2  2  2  2  2  2  2  2  2  2  2  2  2  2  2  2  2  2  2  2  2  2  2  2  2  2  2  2  2  2  2  2  2  2  2  2  2  2  2  2  2  2  2  2  2  2  2  2  2  2  1  0
1  2  2  2  2  2  2  2  2  2  2  2  2  2  2  2  2  2  2  2  2  2  2  2  2  2  2  2  2  2  2  2  2  2  2  2  2  2  2  2  2  2  2  2  2  2  2  2  2  2  2  2  2  2  2  2  2  2  2  1  0 
1  0  0  0  0  0  0  0  0  0  0  0  0  0  0  0  0  0  0  0  0  0  0  0  0  0  0  0  0  0  0  0  0  0  0  0  0  0  0  0  0  0  0  0  0  0  0  1  0  0  0  0  0  1  0  0  0  0  0  1  0
1  0  0 20 20  0  0  0  0  0  0  0  0  0  0  0  0  0  0  0  0  0  0  0  0  0  0  0  0  0  0  0  0  0  0  0  0  0  0  0  0  0  0  0  0  0  0  1 20 20  6  6  0  1  0  0  0  0  0  1  0
1  5  5  1  1  0  0  0  0  0  0  0  0  0  0  0  0  0  0  0  0  0  0  0  0  0  0  0  6  0  0  0  0  0  0  0  0  0  0  0  0  0  0  0  0  0  0  1  0  0  0  0  0  1  0  0  0  0  0  1  0
1  5  5  1  1  1  0  0  0  0  0  0  0  0  0  0  0  0  0  0  0  0  0  0  0  1  1  1  1  1  1  1  1  5  5  1  1  1  1  1  1  1  1  1  1  1  1  1  8  6  0  0  0  1  0  0  0  0  0  1  0
1  5  5  1  1  1  1  0  0  0  0  0  0  0  0  0  0  0  0  0  0  0  0  0  0  1  0  0  0  0  0  0  1  5  5  0  0  0  0  0  0  0  0  0  0  0  0  1  1  0  0  6  0  1  0  0  0  0  0  1  0
1  5  5  1  1  1  1  1 20  0  0  0  0  0  0  0  0  0  0  0  0  0  0  0  1  1  0  0  0  0  0  0  1  5  5  0  0  0  0  0  0  0  0  0  0  0  0  1  1  1  0 20 20  3  0  0  0  0  0  1  0
1  5  5  1  1  1  1  1  1  1  1  5  5  1  1  1  1  1  1  1  0  0  0  0  1  1  0  6  0  0  0  0  1  5  5  0  0  0  0 20 20 20 20 20  6  6  6  1  1  1  1  0  0  1  0  0  0  0  0  1  0
1  5  5  1  0  0  0  0  0  0  0  5  5  0  0  0  0  0  0  1  0  0 20  1  1  1  4 20 20  6  0  0  1  5  5  1  1  1  1  1  1  1  1  1  1  1  1  1  1  1  1  1  1  1  1  1  1  5  5  1  0
1  5  5  1  0  0  0  0  0  0  0  5  5  0  0  0  0  0  0  1  1  1  1  1  1  1  1  1  1  1  5  5  1  5  5  0  0  0  0  0  0  0  0  0  0  0  0  0  0  0  0  0  0  0  0  0  0  5  5  1  0
1  5  5  1  0  0  0  0  0  0  0  5  5  0  0  0  0  0  0  0  0  0  0  1  0  0  0  0  0  0  5  5  1  5  5  0  0  0  0  0  0  0  0  0  0  0  0  0  0  0  0  0  0  0  0  0  0  5  5  1  0
1  5  5  1  0  0  0  0  0  0  0  5  5  0  0  0  0  0  0  0  0  0  0  1  0  0  0  0  0  0  5  5  1  5  5  0  0  0  0  0  0  0  0  0  0  0  0  0  0  0  0  0  0  0  0  0  0  5  5  1  0
1  5  5  1  0  0  0  0  0  0  0  5  5  0  0  0  0  0  0  0  0  6  6  1  0  0  0  0  0  0  5  5  1  5  5  0  0  0  0  0  0  0  0  0  0  0  0  0  0  0  0  0  0  0  0  0  0  5  5  1  0
1  5  5  1  0  0  0  0  0  0  0  1  1  1  1  1  1  1  1  5  5  1  1  1  0  0  0  0  0  0  5  5  1  5  5  0  0  0  0  0  0  0  0  0  0  0  0  0  0  0  0  0  0  0  0  0  0  5  5  1  0
1  5  5  1  0  0  0  0  6  6  6  1  2  2  2  2  2  2  1  5  5  1  0  0  0  0  0  0  0  0  5  5  1  5  5  6 20 20  0  0  0  0  0 10 20 20  6 10 20  6 20 10  0  0  0 11  0  5  5  1  0
1  5  5  1  0  0  0  0  1  1  1  1  2  2  2  2  2  2  1  5  5  1  0  0  0  0  0  0  0  0  5  5  1  1  1  1  1  1  1  1  1  1  1  1  1  1  1  1  1  1  1  1  1  1  1  1  1  5  5  1  0
1  5  5  1  0  0  0  0  0  0  0  1  2  2  2  2  2  2  1  5  5  1  0  0  0  0  0  0  0  0  5  5  0  0  0  0  0  0  0  0  0  0  0  0  0  0  0  0  0  0  0  0  0  0  0  0  0  5  5  1  0
1  5  5  1  0  0  6  6  0  0  0  1  2  2  2  2  2  2  1  5  5  1  0  0  0  0  0  0  0  0  5  5  0  0  0  0  0  0  0  0  0  0  0  0  0  0  0  0  0  0  0  0  0  0  0  0  0  5  5  1  0
1  5  5  1  0  0  1  1  0  0  0  1  2  2  2  2  2  2  1  5  5  1  0  0  0  0  0  0  0  0  5  5  0  0  0  0  0  0  0  0  0  0  0  0  0  0  0  0  0  0  0  0  0  0  0  0  0  5  5  1  0
1  5  5  1  0  0  0  0  0  0  0  1  2  2  2  2  2  2  1  5  5  1  0  0  0  0  0  0  0  0  5  5  0  0  0  0  0  0  0  0  0  0  0  0  0  0  0  0  0  0  0  0  0  0  0  0  0  5  5  1  0
1  5  5  1  6  0  0  0  0  0  0  1  2  2  2  2  2  2  1  5  5  1  0  0  0  0  0  0  0  0  5  5  0  0  0  0  0  0  0  0  0  0  0  0  0  0  0  0  0  0  0  0  0  0  0  0  0  5  5  1  0
1  5  5  1  1  0  0  0  0  0  0  1  2  2  2  2  2  2  1  5  5  1  0  0  0  0  0  0  0  0  5  5  0  0  0  0  0  0  0  0  0  0  0  0  0  0  0  0  0  0  0  0  0  0  0  0  0  5  5  1  0
1  5  5  1  0  0  0  0  0  0  0  1  2  2  2  2  2  2  1  5  5  1  0  0  0  0  0  0  0  0  5  5  0  0  0  0  0  0  0  0  0  0  0  0  0  0  0  0  0  0  0  0  0  0  0  0  0  5  5  1  0
1  5  5  1  0  0  0  0  0  0  1  1  2  2  2  2  2  2  1  5  5  1  6  6  6  6  0  0  0  0  5  5  0  0  0  0  0  0  0  0  0  0  0  0  0  0  6  0  0  0  0  0  0  0  0  0  0  5  5  1  0
1  5  5  1 10 10 10 10 10 10  1  2  2  2  2  2  2  2  1  5  5  1  1  1  1  1  1  1  1  1  5  5  1  1  1  1  1  0  0  0  0  0  0  0  0  1  1  1  0  0  0  0  0  0  0  0  0  1  1  1  0
1  5  5  1  1  1  1  1  1  1  1  2  2  2  2  2  2  2  1  5  5  0  0  0  0  0  0  0  0  0  5  5  0  0  0  0  1  0  0  0  0  0  0  0  0  0  0  0  0  0  0  0  0  0  0  0  0  1  1  1  0 
1  5  5  0  0  0  1  0  0  0  1  2  2  2  2  2  2  2  1  5  5  0  0  0  0  0  0  0  0  0  5  5  0  0  0  0  1  0  0  0  0  0 20  0  0  0  0  0  0  0  0  0  0  0  0  0  1  1  1  1  0
1  5  5  0  0  0  1  0  0  0  1  2  2  2  2  2  2  2  1  5  5  0  0  0  0  0  0  0  0  0  5  5  0  0  0  0  1  0  0  0  0  1  1  1  0  0  0  0  0  0  0  0  0  0  0  1  1  1  1  1  0
1  5  5  0  0  0  9  0  7  0  1  2  2  2  2  2  2  2  1  5  5  0  0  0  0  0  0  0  0  0  5  5  0  0  0  0  1  0  0  0  0  0  0  0  0  0  0  0  0  0  0  0  0  0  1  1  1  1  1  1  0
1  5  5  0  0  0  1  0  0  0  1  2  2  2  2  2  2  2  1  5  5  0  0  0  0  0  0  0  0  0  5  5  0  0  0  0  1  0  0  0  0 10 10 10 10 10 10 10 10 10  1  1  1  1  1  1  1  1  1  1  0
1  1  1  1  1  1  1  1  1  1  1  1  1  1  1  1  1  1  1  1  1  1  1  1  1  1  1  1  1  1  1  1  1  1  1  1  1  1  1  1  1  1  1  1  1  1  1  1  1  1  1  1  1  1  1  1  1  1  1  1  0
1  2  2  2  2  2  2  2  2  2  2  2  2  2  2  2  2  2  2  2  2  2  2  2  2  2  2  2  2  2  2  2  2  2  2  2  2  2  2  2  2  2  2  2  2  2  2  2  2  2  2  2  2  2  2  2  2  2  2  2  0
1  2  2  2  2  2  2  2  2  2  2  2  2  2  2  2  2  2  2  2  2  2  2  2  2  2  2  2  2  2  2  2  2  2  2  2  2  2  2  2  2  2  2  2  2  2  2  2  2  2  2  2  2  2  2  2  2  2  2  2  0
